peculiar - специфический, особенный
meek - кроткий, мягкий, покорный
charitable - благотворительный, щедрый
burden - ноша, груз, грузить, нагружать
revenue - доход, выручка
pop up - неожиданно возникнуть, вскочить
strictly - точно, определенно
converse - обратное утверждение
scarce - недостаточный, скудный
pace - скорость, темп, задавать темп
piecemeal - по частям, постепенно
relieve - помогать, оказывать помощь
presumably - предположительно, возможно
derive - получать, извлекать
essentially - по существу (дела)
nuisance - неудобство, помеха
conscious - сознательный, здравый
fringe - край, карайность
shore - берег, подпорка, подпирать
worship - поклонение, почитание
adopt - принимать, усыновлять
vibrant - живой, энергичный
prophet - пророк,проповедник
beside - рядом с, близ
premise - предпосылка, исходное условие
resort - прибежище, прибегать
unwieldy - большой, громоздкий
conceal - скрывать, утаивать
expense - затрата, расход
contestant - соперник, участник
challenge - сложная задача, проблема
eventually - в конечном счете, в итоге
gloom - мрак, темнота, депрессия
inspiration - вдохновление, влияние
grasp - схватить, понять
surpass - превосходить
divert - отводить, переключать
scholar - ученый, знаток
render - приводить в какое-л. состояние
former - бывший, предшествующий, из двух вар. первый
subsidiary - вспомогательный, добавочный, дочерняя компания
lodge - подавать, предъявлять
yokel - деревенщина, неотесанный парень, мужлан
languish - увядать, томиться
whilst - пока
resentment - негодование
apprenticeships - обучение
deliberately - сознательно, обдуманно
afford - (быть в состоянии) позволить себе
handful - пригоршня, горсть
gory - окровавленный, кровопролитный
levy - сбор, взимание (взимать) налог
entrepreneur - бизнесмен, предприниматель
application - просьба, заявление (форма)
whale - кит, бить китов
cold spell - похолодание
leaflet - листочек, тонкая брошюра
in advance - впереди, до, заблаговременно
interrogate - осведомляться, спрашивать
on behalf of - от лица, от имени (кого-л.)
grumble - ворчание (-ть), рычание (-ть)
dare - отважиться, посметь
obscure - скрытый, скрывать, прятать
turnover - (товаро) оборот
smack - вкус, иметь вкус
contagious - заразный
grumpy - несдержанный, сварливый
amusing - забавный, занимательный
abide by - придерживатьтся, выполнять
dawn - становиться ясным, доходить
receptionist - служащий в приемной
ebullient - полный энузиазма, энергии
temper - характер, сдежанность (-ться)
moan - стон (-ть), жалоба (-ться)
fire - увольнять
ban - запрещение, запрещать
cut - уменьшение, сокращение
extreme - исключительный, особенный
shortfall - дефецит, недостаток
suspicion - подозрение
diversify - изменять, модифицировать
prompt - побуждать, вызывать
standoff - зазор, отклонение
fear - боязнь, опасение, страх
serve - служить
severe - резкий
cutback - понижение, сокращение
utility - коммунальные услуги
shortage - нехватка
avert - предотвращать
obligation - гарантия, обязательство
contractual - договорной
spokesman - представитель, оратор
tense - напряженный, натянутый
domestic - домашний, внутренний, отечественный
onward - продвигающийся (идущий) вперед
amid - между, посреди
spell - влечь за собой
respective - соответственный (-ующий)
immaterial - неважный, несущественный
disposal - распоряжение (-ться)
neglect - пренебрежение (-ть)
resort - прибежище (-ть), обращение (-ться)
acquisition - приобретение
bond - связь
accuse -  обвинять
erupt - извергать, выбрасывать
turning point - решающий момент
regard - расценивать, считать
shrug - пожимание (-ть) (плечами)
reveal - открывать, разоблачать
crux - главный вопрос
humiliate - унижать, оскорблять
prosecutor - обвинитель, прокурор
summon - вызывать (в суд)
renovate - обновлять, восстанавливать
ambassador - посол
momentum - толчок, импульс
prospect - перспектива, планы на будующее
venue - место сбора, встречи
relief - облегчение, помощь
bulwark - вал, бастион, защита
disgruntle - сердить, досаждать, раздражать
reportedly - по сообщениям, как сообщают
bristle - щетина (-ся), рассердиться
withdraw - ретироваться, уходить
bid - приглашение (-ть)
boil down - сводиться к чему-л
rife - обычный, частый, изобилующий, кишаший
speculation - размышление, предположение, догадка
chancellery - звание кнцлера, канцелярия
all in all - в итоге, всего, в общем
precaution - предосторожность, предусмотрительность
treaty - договор, соглашение, конвенция
purposeful - целенаправленный, важный, намеренный, умышленный
recurrence - повторение, повторное проявление, возврат, рекуррентность
penpal - друг по переписке
impose - класть, помещать, налагать (ограничения), навязывать
stance - поза, положение, позиция, установка
tax - налог, пошлина, облагать пошлиной, устанавливать или брать плату
sluice - шлюз, канал, оборудовать шлюзами
treatment - обращение, обработка, лечение
suburb - окраина, пригород, окрестности
condemn - осуждать, порицать, обрекать, браковать
abstention - ограничение, воздержание (также при голосовании)
prosecutor - исполнитель, обвинитель, прокурор
surveillance - надзор, наблюдение
authorise - уполномачивать, поручать, разрешать
lower house - нижняя палата
legislation - закон, законодательство, законодательная деятельность
controversial - спорный, дискуссионый, полемический
blanket - шерстяное одеяло, покров, общий, всеохватывающий
benign - добрый, мягкий, благоприятный
curious - любопытный, пытливый, чудной, тщательный
offend - погрешить, нарушить, обижать, оскорблять
meaningful  - выразительный, многозанчительный
deplorable - плачевный, прискорбный, печальный
couple - пара, два, соединять(ся), связывать(ся)
intrusive - навязчивый, назойливый
retention - удерживание, сохранение, продолжительное использование
pastime - приятное времяпрепровождение, развлечение
spouse - супруг, супруга, муж, жена
trophy - трофей, добыча, приз, награда
revamp - поправлять, ремонтировать
editor-in-chief - главный редактор
leverage - действие рычага, сила усилие
colleague - коллега, сослуживец
outgrow - перерастать, вырастать
anticipate - ожидать, приближать, предвосхищать
overhead - накладные расходы, служебные данные, верхний, надземный
latch - щеколда, засов, ловить, хватать
collaborate - работать совместно, сотрудничать, предательски сотрудничать
orphan - сирота, лишенный поддержки, опоры, сиротский
insight - проницательность, интуиция
implication - вовлечение, замешанность, следствие, вывод
intention - намерение, стремление, значение, идея
intentionally - нарочно
pertinent - уместный подходящий, имеющий отношение
adhere - прилипать, твердо держаться, придерживаться чего-либо
explicit - заключение, ясный, подробный, явный
implicit - подразумеваемый, не выраженный явно, свойственный
odd - нечетный, чуждый, странный
meanwhile, meantime - тем временем, между тем
expose - подвергать (действию, опасности), разоблачать, разоблачение
imply - предполагать, подразумевать, выражать неявно, намекать
wonder - удивление, изумление, чудо, удивляться
authority - власть, полномочие, авторитет
authenticate - заверять, подтверждать, удостоверять
lame - хромой, увечный, неудовлетворительный, калечить
plumb - вертикальный, грузик отвеса, лот, отвесный
frustrate - расстраивать, срывать, препятствовать, мешать
perturb - возмущать, тревожить, беспокоить, волновать
accountant - бухгалтер, счетовод
spite - злоба, недоброжелательство, досаждать, делать назло
extensive - пространственный, громадный, всесторонний, исчерпывающий
predominate - господствовать, преобладать, доминировать, возвышаться
Monday - понедельник
Tuesday - вторник
Wednesday - среда
Thursday - четверг
Friday - пятница
Saturday - суббота
Sunday - воскресенье
detrimental - приносящий убыток, причиняющий ущерб, вредный, вредная вещь
testimonial - характеристика, подношение, благодарственный, приветственный
versatile - многосторонний, разносторонний, изменчивый, универсальный
